17,09,09,09,09,09,14,13,13,13,13,13,13,11,09,09,09,09,09,09
17,09,07,06,08,09,14,13,13,13,13,13,13,13,18,11,09,10,18,18
17,09,04,00,02,09,16,15,15,15,15,15,15,15,15,12,09,14,13,13
17,09,05,01,03,09,09,09,09,09,09,09,07,06,08,09,09,14,13,13
13,11,09,09,09,09,09,09,09,09,09,09,04,00,02,09,09,16,15,15
13,13,18,11,09,09,09,09,10,18,-1,09,05,01,03,09,09,09,09,09
15,15,13,17,09,09,09,09,14,13,17,09,09,09,09,09,09,09,09,09
09,09,16,12,09,09,09,09,16,15,12,09,09,09,09,09,09,09,09,07
09,09,09,09,09,09,09,09,09,09,07,06,06,06,08,10,18,11,09,04
09,09,09,09,09,09,09,09,09,09,04,00,00,00,02,14,13,17,09,04
09,09,10,18,18,18,18,18,18,11,04,00,00,00,02,14,13,17,09,05
18,18,13,13,13,13,13,13,13,17,05,01,01,01,03,16,15,12,09,09
15,15,15,15,13,13,13,13,13,17,09,09,09,09,09,09,09,09,09,09
09,09,09,09,14,13,13,13,13,17,09,09,09,09,09,09,09,09,09,09
09,09,09,09,16,13,13,13,13,17,09,09,09,09,09,09,09,09,10,18
09,10,11,09,09,16,15,15,15,12,09,09,09,09,06,06,08,09,14,13
09,16,12,09,09,09,09,09,09,09,09,09,09,07,00,00,00,09,14,13
09,09,09,08,09,09,09,09,09,09,09,09,09,01,01,01,03,09,14,13
09,05,01,03,09,09,09,10,18,11,09,09,09,09,09,09,09,09,14,13
09,09,09,09,10,18,18,13,13,17,09,09,09,10,11,09,09,09,14,13

1,0,0,0,0,0,1,0,0,0,0,0,0,1,0,0,0,0,0,0
1,0,0,0,0,0,1,0,0,0,0,0,0,0,1,1,0,1,1,1
1,0,0,0,0,0,1,1,1,1,1,1,1,1,1,1,0,1,0,0
1,0,0,0,0,0,0,0,0,0,0,0,0,0,0,0,0,1,0,0
0,1,0,0,0,0,0,0,0,0,0,0,0,0,0,0,0,1,1,1
0,0,1,1,0,0,0,0,1,1,1,0,0,0,0,0,0,0,0,0
1,1,0,1,0,0,0,0,1,0,1,0,0,0,0,0,0,0,0,0
0,0,1,1,0,0,0,0,1,1,1,0,0,0,0,0,0,0,0,0
0,0,0,0,0,0,0,0,0,0,0,0,0,0,0,1,1,1,0,0
0,0,0,0,0,0,0,0,0,0,0,0,0,0,0,1,0,1,0,0
0,0,1,1,1,1,1,1,1,1,0,0,0,0,0,1,0,1,0,0
1,1,0,0,0,0,0,0,0,1,0,0,0,0,0,1,1,1,0,0
1,1,1,1,0,0,0,0,0,1,0,0,0,0,0,0,0,0,0,0
0,0,0,0,1,0,0,0,0,1,0,0,0,0,0,0,0,0,0,0
0,0,0,0,1,0,0,0,0,1,0,0,0,0,0,0,0,0,1,1
0,1,1,0,0,1,1,1,1,1,0,0,0,0,0,0,0,0,1,0
0,1,1,0,0,0,0,0,0,0,0,0,0,0,0,0,0,0,1,0
0,0,0,0,0,0,0,0,0,0,0,0,0,0,0,0,0,0,1,0
0,0,0,0,0,0,0,1,1,1,0,0,0,0,0,0,0,0,1,0
0,0,0,0,1,1,1,0,0,1,0,0,0,1,1,0,0,0,1,0

